############################
#............##............#
#.####.#####.##.#####.####.#
#.####.#####.##.#####.####.#
#.####.#####.##.#####.####.#
#..........................#
#.####.##.########.##.####.#
#.####.##.########.##.####.#
#......##....##....##......#
######.#####.##.#####.######
######.#####.##.#####.######
######.##..........##.######
######.##.###  ###.##.######
######.##.#      #.##.######
..........# 2345 #..........
######.##.#      #.##.######
######.##.########.##.######
######.##..........##.######
######.##.########.##.######
######.##.########.##.######
#............##............#
#.####.#####.##.#####.####.#
#.####.#####.##.#####.####.#
#...##.P..............##...#
###.##.##.########.##.##.###
###.##.##.########.##.##.###
#......##....##....##......#
#.##########.##.##########.#
#.##########.##.##########.#
#..........................#
############################
