############################
#..........................#
#..........................#
#..........................#
#..........................#
#..........................#
#..........................#
#..........................#
#..........................#
#..........................#
#..........................#
#..........................#
#..........................#
#..........................#
#...........2345...........#
#..........................#
#..........................#
#..........................#
#..........................#
#..........................#
#..........................#
#..........................#
#..........................#
#......P...................#
#..........................#
#..........................#
#..........................#
#..........................#
#..........................#
#..........................#
############################
